111111111111111111111111111111
111010110001101111111000000001
101010000000001111111100000001
110011101111101111110001000001
10010E000110001111110000000011
101100000111111111110000000001
111111110000001111110000000001
100010000010000100000000000001
100000010000000100000000000001
100100000000000000000000000001
10000001000100010000C010000001
100000000000000100001011101001
100100000000000100111010111111
1000000000000011100010000P0001
111111111111111111111111111111
