111111111111111111111
1E1C1011C0011C1111111
1CC000C00000001111111
110011101111101111111
1001000C011C001111111
1011C000C111111111111
1C11P1110000001111111
111111111111111111111