111111111111111
1E1C1011C0011C1
1CC000C0000P001
110011101111101
1001100C011C001
1011C000C1111C1
1C1111110000001
111111111111111